_____________Racourcis Intelij_____________

psvm => fonction main()

sout => println()

Ctrl Z  => Undo


Ctrl Shift F10  => lance Run

Ctrl F5  => re run le main

Ctrl F9  => Rebuild

Shift Escap  => Hide Terminal | Project directories


Ctrl Shift /  => Commenter une selection de ligne en block

Ctrl /  => Commenter une ligne

Ctrl Space  => code Completion, si on le met apres un . IDE affiche toutes propositions de méthode possible

Ctrl Y  => Delete la ligne ou le curseur ce trouve

Ctrl D  => Dupliquer une ligne ou le curseur ce trouve

Ctrl W  => étendre une selection sur une ligne depuis l'endroit ou se trouve le curseur

Ctrl O  => pour voire toutes les methodes @Override de la class mére

Ctrl N => Navigation = Tape le nom de la class ou on veut aller

Ctrl B  => clic sur un objet pour Naviguer la ou l'objet a été initialisé

Ctrl P  => character info il faut placer le curseur entre les parenthése d'1 methode ou sur la methode, affiche les différentes version de la methode avec leur signatures (input + output)

Ctrl Q  => afficher la javaDoc

Ctrl Space => place le curseur aprés un point (class.) pour afficher les methode dispo dans cette class

Ctrl F  => faire une recherche sur la class ou on est

Ctrl Shift F  => faire une recherche sur tout le projet


Ctrl Alt ->  => Navigate forward

Ctrl Alt <-  => Navigate back la ou on était juste avant

Ctrl Alt V  => Mettre une selection de code (ou curseur en fin de ligne) dans une variable sur une ligne propre, la variable uniquement sera appelé à l'endroit original

Ctrl Alt N  => défait la factorisation (place le curseur sur l'utilisation de la variable)

Ctrl Alt Enter => Commencer une nell ligne au-dessus de la ou est le curseur

Shift Enter  => commencer une nell ligne en dessous de la ou est le curseur

Shift F6  => renommer une variable partout apres l'avoir select


Alt Shift  => mettre le curseur à plusieurs endroits en meme temps pour modif

Alt Shift (fleche vers le haut) => déplacer une ligne vers le haut

Alt Shift (fleche vers le bas) => déplacer une ligne vers le bas

Alt Enter  => importer une class

Alt Insert => Ouvrir générator => constructor | getter setter | toString()

Alt 1  => Open Project

clic date verte gauche interface => affiche toutes les class qui utilise cette interface

Pb curseur carré => touche insert

Clic D / Column Selection Mode = Alt Maj Insert => On passe d'un style de selection horizontal à un style vertical . C'est une façon de sélectionner rapidement des éléménts sur plusieurs lignes

/** enter => pour créer une JavaDoc sur une methode ...








